00,00,00,00,00,00,00,00,00,00,00,00,00,00,40
00,00,40,00,00,30,00,00,00,40,00,00,00,00,00
00,00,00,00,01,00,00,00,00,00,01,00,50,00,00
00,00,00,00,40,01,00,00,30,01,30,00,00,00,00
04,00,00,00,00,00,50,00,50,00,00,00,00,00,05
00,00,00,00,30,01,30,00,00,01,40,00,00,00,00
00,00,50,00,01,00,00,00,00,00,01,00,00,00,00
00,00,00,00,00,40,00,00,00,30,00,00,40,00,00
40,00,00,00,00,00,00,00,00,00,00,00,00,00,00
