30,0,0,0,0,0,0,0,0,0,0,0,0,0,40
0,0,0,0,1,30,0,0,0,40,1,0,0,0,0
0,0,0,0,40,1,0,0,0,1,30,0,0,0,0
0,0,0,0,0,0,1,0,1,0,0,0,0,0,0
4,0,0,0,40,0,50,0,50,0,40,0,0,0,5
0,0,0,0,0,0,1,0,1,0,0,0,0,0,0
0,0,0,0,30,1,0,0,0,1,40,0,0,0,0
0,0,0,0,1,40,0,0,0,30,1,0,0,0,0
40,0,0,0,0,0,0,0,0,0,0,0,0,0,30
