40,00,00,00,00,00,00,00,00,00,00,00,00,00,50
00,00,00,00,01,00,00,00,00,00,01,00,00,00,00
00,00,00,00,00,01,00,00,00,01,00,00,00,00,00
00,50,00,00,00,00,01,30,01,00,00,00,00,40,00
00,00,00,00,00,04,01,00,01,05,00,00,00,00,00
00,40,00,00,00,00,01,30,01,00,00,00,00,50,00
00,00,00,00,00,01,00,00,00,01,00,00,00,00,00
00,00,00,00,01,00,00,00,00,00,01,00,00,00,00
50,00,00,00,00,00,00,00,00,00,00,00,00,00,40
