30,0,0,0,1,0,0,0,0,0,1,0,0,0,30
0,0,1,0,50,30,1,30,1,30,50,0,1,0,0
40,0,40,0,1,0,40,0,40,0,1,0,40,0,40
0,0,1,0,50,0,1,30,1,0,50,0,1,0,0
4,0,40,0,1,30,50,0,50,30,1,0,40,0,5
0,0,1,0,50,0,1,30,1,0,50,0,1,0,0
40,0,40,0,1,0,40,0,40,0,1,0,40,0,40
0,0,1,0,50,30,1,30,1,30,50,0,1,0,0
30,0,0,0,1,0,0,0,0,0,1,0,0,0,30
